"492","597","21978","999999","date","other"
"9","9","3","","2018-09-12","0"
"20","22","6","","2018-09-26","0"
"20","22","6","","2018-10-10","0"
"20","22","6","","2018-10-24","0"
"20","22","6","","2018-11-07","0"
"20","22","6","","2018-11-21","0"
"20","22","6","","2018-12-05","0"
"20","22","6","","2018-12-19","0"
"20","22","6","","2019-01-02","0"
"20","22","6","","2019-01-16","0"
"20","22","6","","2019-01-30","0"
"20","22","6","","2019-02-13","0"
"20","22","6","","2019-02-27","0"
"13","14","4","","2019-03-13","0"
"7","8","2","","2019-03-27","0"
"20","22","6","","2019-04-10","0"
"20","22","6","","2019-04-24","0"
"10","11","3","","2019-05-08","0"
"10","11","3","","2019-05-22","0"
"20","22","6","","2019-06-05","0"
"20","22","6","","2019-06-19","0"
"20","22","6","","2019-07-03","0"
"21","24","6","","2019-07-17","0"
"20","22","6","","2019-07-31","0"
"20","22","6","","2019-08-14","0"
"20","22","6","","2019-08-28","0"
"23","25","7","0","2019-09-11","0"
"20","22","6","1","2019-09-25","0"
"20","22","6","1","2019-10-09","0"
"21","24","6","1","2019-10-23","0"
"20","22","6","1","2019-11-06","0"
"20","22","6","1","2019-11-20","0"
"21","24","6","1","2019-12-04","0"
"30","33","9","2","2019-12-18","0"
"20","22","6","1","2020-01-01","0"
"21","24","6","1","2020-01-15","0"
"20","22","6","1","2020-01-29","0"
"19","20","6","1","2020-02-12","0"
"19","20","6","1","2020-02-26","0"
"21","24","6","1","2020-03-11","0"
"20","22","6","1","2020-03-25","0"
"21","24","6","1","2020-04-08","0"
"21","24","6","1","2020-04-22","0"
"20","22","6","1","2020-05-06","0"
"21","24","6","1","2020-05-20","0"
"20","22","6","1","2020-06-03","0"
"20","22","6","1","2020-06-17","0"
"19","20","6","1","2020-07-01","0"
"17","19","5","1","2020-07-15","0"
"23","25","7","1","2020-07-29","0"
"16","17","5","1","2020-08-12","0"
"19","20","6","1","2020-08-26","0"
"21","24","6","1","2020-09-09","0"
"23","25","7","1","2020-09-23","0"
"30","33","9","2","2020-10-07","0"
"21","24","6","1","2020-10-21","0"
"19","20","6","1","2020-11-04","0"
"24","27","7","1","2020-11-18","0"
"20","22","6","1","2020-12-02","0"
"20","22","6","1","2020-12-16","0"
"23","25","7","1","2020-12-30","0"
"20","22","6","1","2021-01-13","0"
"26","28","8","1","2021-01-27","0"
"13","14","4","1","2021-02-10","0"
"20","22","6","1","2021-02-24","0"
"20","22","6","1","2021-03-10","0"
"20","22","6","1","2021-03-24","0"
"20","22","6","1","2021-04-07","0"
"20","22","6","1","2021-04-21","0"
"20","22","6","1","2021-05-05","0"
