"492","597","date","other"
"11","11","2020-07-15","0"
"21","21","2020-07-29","0"
"21","21","2020-08-12","0"
"20","20","2020-08-26","0"
"20","20","2020-09-09","0"
"24","24","2020-09-23","0"
"21","21","2020-10-07","0"
"17","17","2020-10-21","0"
"27","27","2020-11-04","0"
"26","26","2020-11-18","0"
"26","26","2020-12-02","0"
"20","20","2020-12-16","0"
"24","24","2020-12-30","0"
"21","21","2021-01-13","0"
"23","23","2021-01-27","0"
"17","17","2021-02-10","0"
"21","21","2021-02-24","0"
"21","21","2021-03-10","0"
"23","23","2021-03-24","0"
"21","21","2021-04-07","0"
"21","21","2021-04-21","0"
"21","21","2021-05-05","0"
