"19","21","122","492","21978","999999","date","other"
"9","9","9","9","1","0","2018-10-10","0"
"21","21","21","21","5","1","2018-10-24","0"
"21","21","21","21","5","1","2018-11-07","0"
"21","21","21","21","5","1","2018-11-21","0"
"21","21","21","21","5","1","2018-12-05","0"
"21","21","20","21","5","1","2018-12-19","0"
"21","21","20","21","5","1","2019-01-02","0"
"21","21","20","21","5","1","2019-01-16","0"
"21","21","20","21","5","1","2019-01-30","0"
"21","21","20","21","5","1","2019-02-13","0"
"21","21","20","21","5","1","2019-02-27","0"
"20","20","19","20","5","1","2019-03-13","0"
"21","21","20","21","5","1","2019-03-27","0"
"21","21","20","21","5","1","2019-04-10","0"
"21","21","20","21","6","1","2019-04-24","0"
"11","11","10","11","4","1","2019-05-08","0"
"12","12","11","12","4","1","2019-05-22","0"
"21","21","20","21","7","1","2019-06-05","0"
"20","20","19","20","7","1","2019-06-19","0"
"21","21","20","21","7","1","2019-07-03","0"
"23","23","21","23","8","1","2019-07-17","0"
"24","24","23","24","8","1","2019-07-31","0"
"18","18","17","18","6","1","2019-08-14","0"
"23","23","21","23","8","1","2019-08-28","0"
"20","20","19","20","7","1","2019-09-11","0"
"24","24","23","24","8","1","2019-09-25","0"
"24","24","23","24","8","1","2019-10-09","0"
"21","21","20","21","7","1","2019-10-23","0"
"23","23","21","23","8","1","2019-11-06","0"
"24","24","23","24","8","1","2019-11-20","0"
"26","26","24","26","9","1","2019-12-04","0"
"27","27","26","27","10","1","2019-12-18","0"
"24","24","23","24","9","1","2020-01-01","0"
"24","24","23","24","9","1","2020-01-15","0"
"23","23","21","23","9","1","2020-01-29","0"
"27","27","26","27","10","1","2020-02-12","0"
"24","24","23","24","9","1","2020-02-26","0"
"24","24","23","24","9","1","2020-03-11","0"
"24","24","23","24","9","1","2020-03-25","0"
"26","26","24","26","10","1","2020-04-08","0"
"20","20","19","20","7","1","2020-04-22","0"
"21","21","20","21","8","1","2020-05-06","0"
"18","18","17","18","7","1","2020-05-20","0"
"24","24","23","24","9","1","2020-06-03","0"
"23","23","21","23","9","1","2020-06-17","0"
"23","23","21","23","9","1","2020-07-01","0"
"18","18","17","18","7","1","2020-07-15","0"
"26","26","24","26","10","1","2020-07-29","0"
"20","20","19","20","7","1","2020-08-12","0"
"29","29","27","29","11","1","2020-08-26","0"
"21","21","20","21","8","1","2020-09-09","0"
"21","21","20","21","8","1","2020-09-23","0"
"20","20","19","20","7","1","2020-10-07","0"
"30","30","29","30","11","1","2020-10-21","0"
"26","26","24","26","10","1","2020-11-04","0"
"26","26","24","26","10","1","2020-11-18","0"
"26","26","24","26","10","1","2020-12-02","0"
"21","21","20","21","8","1","2020-12-16","0"
"23","23","21","23","9","1","2020-12-30","0"
"32","32","30","32","12","2","2021-01-13","0"
"21","21","20","21","8","1","2021-01-27","0"
"11","11","10","11","4","1","2021-02-10","0"
"23","23","21","23","9","1","2021-02-24","0"
"21","21","20","21","8","1","2021-03-10","0"
"23","23","21","23","9","1","2021-03-24","0"
"24","24","23","24","9","1","2021-04-07","0"
"21","21","20","21","8","1","2021-04-21","0"
"23","23","21","23","9","1","2021-05-05","0"
"21","21","20","21","8","1","2021-05-19","0"
