"19","21","492","597","1625","7208","date","other"
"5","5","5","5","2","","2018-01-04","0"
"14","14","15","14","5","","2018-01-18","0"
"13","13","13","13","4","","2018-02-01","0"
"11","11","12","11","4","","2018-02-15","0"
"14","14","15","14","5","","2018-03-01","0"
"14","14","15","14","5","","2018-03-15","0"
"14","14","15","14","5","","2018-03-29","0"
"14","14","15","14","5","","2018-04-12","0"
"22","22","23","22","7","","2018-04-26","0"
"22","22","23","22","7","","2018-05-10","0"
"22","22","23","22","7","","2018-05-24","0"
"20","20","21","20","7","","2018-06-07","0"
"22","22","23","22","7","","2018-06-21","0"
"22","22","23","22","7","","2018-07-05","0"
"22","22","23","22","7","","2018-07-19","0"
"22","22","23","22","7","","2018-08-02","0"
"22","22","23","22","7","","2018-08-16","0"
"22","22","23","22","7","","2018-08-30","0"
"22","22","23","22","7","","2018-09-13","0"
"22","22","23","22","7","","2018-09-27","0"
"22","22","23","22","7","","2018-10-11","0"
"22","22","23","22","7","","2018-10-25","0"
"22","22","23","22","7","","2018-11-08","0"
"22","22","23","22","7","","2018-11-22","0"
"22","22","23","22","7","","2018-12-06","0"
"22","22","23","22","7","","2018-12-20","0"
"22","22","23","22","7","","2019-01-03","0"
"22","22","23","22","7","","2019-01-17","0"
"22","22","23","22","7","","2019-01-31","0"
"22","22","23","22","7","","2019-02-14","0"
"22","22","23","22","7","","2019-02-28","0"
"11","11","12","11","4","","2019-03-14","0"
"20","20","21","20","7","","2019-04-11","0"
"22","22","23","22","7","","2019-04-25","0"
"8","8","8","8","3","","2019-05-09","0"
"14","14","15","14","5","","2019-05-23","0"
"24","24","25","24","8","","2019-06-06","0"
"22","22","23","22","7","","2019-06-20","0"
"24","24","25","24","8","","2019-07-04","0"
"20","20","21","20","7","","2019-07-18","0"
"24","24","25","24","8","","2019-08-01","0"
"22","22","23","22","7","","2019-08-15","0"
"22","22","23","22","7","","2019-08-29","0"
"24","24","25","24","8","","2019-09-12","0"
"24","24","25","24","8","","2019-09-26","0"
"22","22","23","22","7","","2019-10-10","0"
"22","22","23","22","7","","2019-10-24","0"
"22","22","23","22","7","","2019-11-07","0"
"22","22","23","22","7","","2019-11-21","0"
"22","22","23","22","7","","2019-12-05","0"
"20","20","21","20","7","","2019-12-19","0"
"25","25","26","25","8","","2020-01-02","0"
"20","20","21","20","7","","2020-01-16","0"
"22","22","23","22","7","","2020-01-30","0"
"24","24","25","24","8","","2020-02-13","0"
"24","24","25","24","8","","2020-02-27","0"
"22","22","23","22","7","","2020-03-12","0"
"22","22","23","22","7","","2020-03-26","0"
"22","22","23","22","7","","2020-04-09","0"
"20","20","21","20","7","","2020-04-23","0"
"22","22","23","22","7","","2020-05-07","0"
"20","20","21","20","7","","2020-05-21","0"
"24","24","25","24","8","","2020-06-04","0"
"22","22","23","22","7","","2020-06-18","0"
"27","27","28","27","9","","2020-07-02","0"
"20","20","21","20","7","","2020-07-16","0"
"24","24","25","24","8","","2020-07-30","0"
"33","33","35","33","11","","2020-08-13","0"
"22","22","23","22","7","3","2020-08-27","0"
"22","22","23","22","7","5","2020-09-10","0"
"24","24","25","24","8","5","2020-09-24","0"
"22","22","23","22","7","5","2020-10-08","0"
"22","22","23","22","7","5","2020-10-22","0"
"27","27","28","27","9","6","2020-11-05","0"
"24","24","25","24","8","5","2020-11-19","0"
"24","24","25","24","8","5","2020-12-03","0"
"35","35","36","35","11","8","2020-12-17","0"
"25","25","26","25","8","6","2020-12-31","0"
"28","28","30","28","9","6","2021-01-14","0"
"24","24","25","24","8","5","2021-01-28","0"
"17","17","18","17","6","4","2021-02-11","0"
"28","28","30","28","9","6","2021-02-25","0"
"24","24","25","24","8","5","2021-03-11","0"
"24","24","25","24","8","5","2021-03-25","0"
"22","22","23","22","7","5","2021-04-08","0"
"22","22","23","22","7","5","2021-04-22","0"
"25","25","26","25","8","6","2021-05-06","0"
"22","22","23","22","7","5","2021-05-20","0"
