"9","122","492","597","1662","1716","date","other"
"3","3","3","3","1","1","2018-01-04","0"
"22","21","21","22","9","10","2018-01-18","0"
"20","20","20","20","9","9","2018-02-01","0"
"20","20","20","20","9","9","2018-02-15","0"
"22","21","21","22","10","10","2018-03-01","0"
"22","21","21","22","10","10","2018-03-15","0"
"22","21","21","22","10","10","2018-03-29","0"
"22","21","21","22","10","10","2018-04-12","0"
"22","21","21","22","10","10","2018-04-26","0"
"22","21","21","22","10","10","2018-05-10","0"
"22","21","21","22","10","10","2018-05-24","0"
"22","21","21","22","10","10","2018-06-07","0"
"22","21","21","22","10","10","2018-06-21","0"
"22","21","21","22","10","10","2018-07-05","0"
"22","21","21","22","10","10","2018-07-19","0"
"22","21","21","22","10","10","2018-08-02","0"
"22","21","21","22","10","10","2018-08-16","0"
"22","21","21","22","10","10","2018-08-30","0"
"22","21","21","22","10","10","2018-09-13","0"
"22","21","21","22","10","10","2018-09-27","0"
"22","21","21","22","10","10","2018-10-11","0"
"22","21","21","22","10","10","2018-10-25","0"
"22","21","21","22","10","10","2018-11-08","0"
"22","21","21","22","10","10","2018-11-22","0"
"22","21","21","22","11","10","2018-12-06","0"
"23","21","22","22","11","11","2018-12-20","0"
"23","21","22","22","11","11","2019-01-03","0"
"23","21","22","22","11","11","2019-01-17","0"
"23","21","22","22","11","11","2019-01-31","0"
"23","21","22","22","11","11","2019-02-14","0"
"23","21","22","22","11","11","2019-02-28","0"
"23","21","22","22","11","11","2019-03-14","0"
"23","21","22","22","11","11","2019-03-28","0"
"23","21","22","22","11","11","2019-04-11","0"
"23","21","22","22","11","11","2019-04-25","0"
"10","9","9","9","5","5","2019-05-09","0"
"14","12","13","13","6","8","2019-05-23","0"
"26","23","25","25","12","15","2019-06-06","0"
"22","20","21","21","10","15","2019-06-20","0"
"22","20","21","21","10","15","2019-07-04","0"
"24","21","23","23","11","16","2019-07-18","0"
"24","21","23","23","11","17","2019-08-01","0"
"22","20","21","21","10","16","2019-08-15","0"
"22","20","21","21","10","16","2019-08-29","0"
"22","20","21","21","10","16","2019-09-12","0"
"24","21","23","23","11","17","2019-09-26","0"
"24","21","23","23","11","17","2019-10-10","0"
"22","20","21","21","10","16","2019-10-24","0"
"22","20","21","21","10","16","2019-11-07","0"
"24","21","23","23","11","17","2019-11-21","0"
"22","20","21","21","10","16","2019-12-05","0"
"24","21","23","23","11","17","2019-12-19","0"
"21","18","20","20","9","15","2020-01-02","0"
"26","23","25","25","12","18","2020-01-16","0"
"24","21","23","23","11","17","2020-01-30","0"
"26","23","25","25","12","18","2020-02-13","0"
"24","21","23","23","11","17","2020-02-27","0"
"22","20","21","21","10","16","2020-03-12","0"
"24","21","23","23","11","17","2020-03-26","0"
"24","21","23","23","11","17","2020-04-09","0"
"21","18","20","20","9","15","2020-04-23","0"
"24","21","23","23","11","17","2020-05-07","0"
"24","21","23","23","11","17","2020-05-21","0"
"24","21","23","23","11","17","2020-06-04","0"
"27","24","26","26","13","19","2020-06-18","0"
"24","21","23","23","11","17","2020-07-02","0"
"21","18","20","20","9","15","2020-07-16","0"
"24","21","23","23","11","17","2020-07-30","0"
"22","20","21","21","10","16","2020-08-13","0"
"27","24","26","26","13","19","2020-08-27","0"
"22","20","21","21","10","16","2020-09-10","0"
"21","18","20","20","9","15","2020-09-24","0"
"26","23","25","25","12","18","2020-10-08","0"
"24","21","23","23","11","17","2020-10-22","0"
"34","30","33","33","16","24","2020-11-05","0"
"31","27","30","30","14","22","2020-11-19","0"
"24","21","23","23","11","17","2020-12-03","0"
"29","26","28","28","13","21","2020-12-17","0"
"26","23","25","25","12","18","2020-12-31","0"
"24","21","23","23","11","17","2021-01-14","0"
"31","27","30","30","14","22","2021-01-28","0"
"21","18","20","20","9","15","2021-02-11","0"
"26","23","25","25","12","18","2021-02-25","0"
"24","21","23","23","11","17","2021-03-11","0"
"24","21","23","23","11","17","2021-03-25","0"
"24","21","23","23","11","17","2021-04-08","0"
"29","26","28","28","13","21","2021-04-22","0"
"26","23","25","25","12","18","2021-05-06","0"
"26","23","25","25","12","18","2021-05-20","0"
