"21","21978","date","other"
"4","1","2018-03-14","0"
"9","2","2018-03-28","0"
"10","3","2018-04-11","0"
"19","5","2018-04-25","0"
"20","5","2018-05-09","0"
"20","5","2018-05-23","0"
"20","5","2018-06-06","0"
"20","5","2018-06-20","0"
"20","5","2018-07-04","0"
"20","5","2018-07-18","0"
"20","5","2018-08-01","0"
"20","5","2018-08-15","0"
"20","5","2018-08-29","0"
"20","5","2018-09-12","0"
"20","5","2018-09-26","0"
"20","5","2018-10-10","0"
"20","5","2018-10-24","0"
"20","5","2018-11-07","0"
"20","5","2018-11-21","0"
"20","5","2018-12-05","0"
"20","5","2018-12-19","0"
"20","5","2019-01-02","0"
"20","5","2019-01-16","0"
"20","5","2019-01-30","0"
"20","5","2019-02-13","0"
"20","5","2019-02-27","0"
"11","3","2019-03-13","0"
"3","1","2019-03-27","0"
"19","5","2019-04-10","0"
"20","5","2019-04-24","0"
"9","3","2019-05-08","0"
"11","3","2019-05-22","0"
"20","6","2019-06-05","0"
"20","6","2019-06-19","0"
"24","7","2019-07-03","0"
"23","6","2019-07-17","0"
"20","6","2019-07-31","0"
"20","6","2019-08-14","0"
"23","6","2019-08-28","0"
"20","6","2019-09-11","0"
"20","6","2019-09-25","0"
"21","6","2019-10-09","0"
"21","6","2019-10-23","0"
"18","5","2019-11-06","0"
"21","6","2019-11-20","0"
"23","7","2019-12-04","0"
"23","8","2019-12-18","0"
"20","7","2020-01-01","0"
"9","3","2020-09-23","0"
"30","10","2020-10-07","0"
"29","10","2020-10-21","0"
"30","10","2020-11-04","0"
"26","9","2020-11-18","0"
"26","9","2020-12-02","0"
"24","8","2020-12-16","0"
"22","7","2020-12-30","0"
"27","9","2021-01-13","0"
"27","9","2021-01-27","0"
"17","6","2021-02-10","0"
"24","8","2021-02-24","0"
"24","8","2021-03-10","0"
"24","8","2021-03-24","0"
"22","7","2021-04-07","0"
"22","7","2021-04-21","0"
"22","7","2021-05-05","0"
"22","7","2021-05-19","0"
