"21","122","492","date","other"
"13","14","14","2018-10-25","0"
"20","21","21","2018-11-08","0"
"20","21","21","2018-11-22","0"
"20","21","21","2018-12-06","0"
"20","21","21","2018-12-20","0"
"20","21","21","2019-01-03","0"
"20","21","21","2019-01-17","0"
"20","21","21","2019-01-31","0"
"20","21","21","2019-02-14","0"
"20","21","21","2019-02-28","0"
"20","21","21","2019-03-14","0"
"17","18","18","2019-03-28","0"
"20","21","21","2019-04-11","0"
"20","21","21","2019-04-25","0"
"7","8","8","2019-05-09","0"
"13","14","14","2019-05-23","0"
"19","20","20","2019-06-06","0"
"23","24","24","2019-06-20","0"
"23","24","24","2019-07-04","0"
"20","21","21","2019-07-18","0"
"23","24","24","2019-08-01","0"
"21","23","23","2019-08-15","0"
"23","24","24","2019-08-29","0"
"21","23","23","2019-09-12","0"
"21","23","23","2019-09-26","0"
"21","23","23","2019-10-10","0"
"23","24","24","2019-10-24","0"
"21","23","23","2019-11-07","0"
"19","20","20","2019-11-21","0"
"21","23","23","2019-12-05","0"
"26","27","27","2019-12-19","0"
"23","24","24","2020-01-02","0"
"27","29","29","2020-01-16","0"
"20","21","21","2020-01-30","0"
"23","24","24","2020-02-13","0"
"26","27","27","2020-02-27","0"
"21","23","23","2020-03-12","0"
"27","29","29","2020-03-26","0"
"26","27","27","2020-04-09","0"
"17","18","18","2020-04-23","0"
"21","23","23","2020-05-07","0"
"19","20","20","2020-05-21","0"
"24","26","26","2020-06-04","0"
"21","23","23","2020-06-18","0"
"21","23","23","2020-07-02","0"
"17","18","18","2020-07-16","0"
"21","23","23","2020-07-30","0"
"21","23","23","2020-08-13","0"
"17","18","18","2020-08-27","0"
"27","29","29","2020-09-10","0"
"27","29","29","2020-09-24","0"
"24","26","26","2020-10-08","0"
"27","29","29","2020-10-22","0"
"30","32","32","2020-11-05","0"
"29","30","30","2020-11-19","0"
"21","23","23","2020-12-03","0"
"27","29","29","2020-12-17","0"
"27","29","29","2020-12-31","0"
"26","27","27","2021-01-14","0"
"30","32","32","2021-01-28","0"
"11","12","12","2021-02-11","0"
"19","20","20","2021-02-25","0"
"19","20","20","2021-03-11","0"
"20","21","21","2021-03-25","0"
"20","21","21","2021-04-08","0"
"20","21","21","2021-04-22","0"
"20","21","21","2021-05-06","0"
