"122","4085","5577","7208","date","other"
"13","3","4","","2019-07-17","0"
"26","7","8","","2019-07-31","0"
"21","6","7","","2019-08-14","0"
"23","6","7","","2019-08-28","0"
"20","5","6","","2019-09-11","0"
"21","6","7","","2019-09-25","0"
"23","6","7","","2019-10-09","0"
"23","6","7","","2019-10-23","0"
"21","6","7","","2019-11-06","0"
"25","6","8","","2019-11-20","0"
"26","7","8","","2019-12-04","0"
"25","6","8","","2019-12-18","0"
"21","6","7","","2020-01-01","0"
"23","6","7","","2020-01-15","0"
"25","6","8","","2020-01-29","0"
"25","6","8","","2020-02-12","0"
"25","6","8","","2020-02-26","0"
"23","6","7","","2020-03-11","0"
"23","6","7","","2020-03-25","0"
"20","5","6","","2020-04-08","0"
"23","6","7","","2020-04-22","0"
"23","6","7","","2020-05-06","0"
"23","6","7","","2020-05-20","0"
"21","6","7","","2020-06-03","0"
"23","6","7","","2020-06-17","0"
"21","6","7","","2020-07-01","0"
"21","6","7","","2020-07-15","0"
"26","7","8","","2020-07-29","0"
"16","4","5","","2020-08-12","0"
"21","6","7","","2020-08-26","0"
"21","6","7","","2020-09-09","0"
"31","8","10","","2020-09-23","0"
"23","6","7","","2020-10-07","0"
"21","6","7","2","2020-10-21","0"
"21","6","7","5","2020-11-04","0"
"33","9","10","7","2020-11-18","0"
"31","8","10","7","2020-12-02","0"
"23","6","7","5","2020-12-16","0"
"30","8","9","6","2020-12-30","0"
"26","7","8","6","2021-01-13","0"
"30","8","9","6","2021-01-27","0"
"15","4","5","3","2021-02-10","0"
"30","8","9","6","2021-02-24","0"
"23","6","7","5","2021-03-10","0"
"23","6","7","5","2021-03-24","0"
"23","6","7","5","2021-04-07","0"
"23","6","7","5","2021-04-21","0"
"23","6","7","5","2021-05-05","0"
