"19","21","492","493","599","21978","999999","date","other"
"12","12","12","14","12","3","0","2017-12-07","0"
"14","14","14","15","14","4","","2017-12-21","0"
"12","12","12","14","12","4","","2018-01-04","0"
"12","12","12","14","12","4","","2018-01-18","0"
"12","12","12","14","12","4","","2018-02-01","0"
"15","15","15","17","15","5","","2018-02-15","0"
"15","15","15","17","15","5","","2018-03-01","0"
"14","14","14","15","14","5","","2018-03-15","0"
"12","12","12","14","12","4","","2018-03-29","0"
"15","15","15","17","15","5","","2018-04-12","0"
"20","20","20","22","20","7","","2018-04-26","0"
"21","21","21","24","21","7","","2018-05-10","0"
"21","21","21","24","21","7","","2018-05-24","0"
"21","21","21","24","21","7","","2018-06-07","0"
"21","21","21","24","21","8","","2018-06-21","0"
"21","21","21","24","21","8","","2018-07-05","0"
"21","21","21","44","21","8","","2018-07-19","0"
"21","21","21","45","21","8","","2018-08-02","0"
"21","21","21","45","21","8","","2018-08-16","0"
"21","21","21","45","21","8","","2018-08-30","0"
"21","21","21","45","21","8","","2018-09-13","0"
"21","21","21","45","21","8","","2018-09-27","0"
"21","21","21","45","21","8","","2018-10-11","0"
"21","21","21","45","21","8","","2018-10-25","0"
"21","21","21","45","21","8","","2018-11-08","0"
"21","21","21","45","21","8","","2018-11-22","0"
"21","21","21","45","21","8","","2018-12-06","0"
"21","21","21","45","21","8","","2018-12-20","0"
"20","20","20","42","20","7","","2019-01-03","0"
"21","21","21","45","21","8","","2019-01-17","0"
"21","21","21","45","21","8","","2019-01-31","0"
"21","21","21","45","21","8","","2019-02-14","0"
"21","21","21","45","21","8","","2019-02-28","0"
"14","14","14","29","14","5","","2019-03-14","0"
"5","5","5","10","5","2","","2019-03-28","0"
"20","20","20","42","20","7","","2019-04-11","0"
"21","21","21","45","21","8","","2019-04-25","0"
"9","9","9","19","9","3","","2019-05-09","0"
"14","14","14","29","14","5","","2019-05-23","0"
"21","21","21","45","21","8","","2019-06-06","0"
"23","23","23","48","23","9","","2019-06-20","0"
"20","20","20","42","20","7","","2019-07-04","0"
"23","23","23","48","23","9","","2019-07-18","0"
"21","21","21","45","21","8","","2019-08-01","0"
"18","18","18","39","18","7","","2019-08-15","0"
"21","21","21","45","21","8","","2019-08-29","0"
"21","21","21","45","21","8","","2019-09-12","0"
"23","23","23","48","23","9","","2019-09-26","0"
"24","24","24","51","24","9","","2019-10-10","0"
"21","21","21","45","21","8","","2019-10-24","0"
"20","20","20","42","20","7","","2019-11-07","0"
"27","27","27","51","27","8","","2019-11-21","0"
"29","29","29","52","29","8","","2019-12-05","0"
"29","29","29","52","29","8","","2019-12-19","0"
"35","35","35","64","35","10","","2020-01-02","0"
"31","31","31","56","31","9","","2020-01-16","0"
"33","33","33","38","33","10","","2020-01-30","0"
"31","31","31","21","31","9","","2020-02-13","0"
"31","31","31","21","31","9","","2020-02-27","0"
"29","29","29","20","29","8","","2020-03-12","0"
"29","29","29","20","29","8","","2020-03-26","0"
"29","29","29","20","29","8","","2020-04-09","0"
"29","29","29","20","29","8","","2020-04-23","0"
"35","35","35","24","35","10","","2020-05-07","0"
"27","27","27","18","27","8","","2020-05-21","0"
"31","31","31","21","31","9","","2020-06-04","0"
"31","31","31","21","31","9","","2020-06-18","0"
"31","31","31","21","31","9","","2020-07-02","0"
"29","29","29","20","29","8","","2020-07-16","0"
"35","35","35","24","35","10","","2020-07-30","0"
"27","27","27","18","27","8","","2020-08-13","0"
"31","31","31","21","31","9","","2020-08-27","0"
"29","29","29","20","29","8","","2020-09-10","0"
"29","29","29","20","29","8","","2020-09-24","0"
"31","31","31","21","31","9","","2020-10-08","0"
"27","27","27","18","27","8","","2020-10-22","0"
"31","31","31","21","31","9","","2020-11-05","0"
"42","42","42","29","42","12","","2020-11-19","0"
"35","35","35","24","35","10","","2020-12-03","0"
"40","40","40","27","40","12","","2020-12-17","0"
"29","29","29","20","29","8","","2020-12-31","0"
"35","35","35","24","35","10","","2021-01-14","0"
"40","40","40","27","40","12","","2021-01-28","0"
"27","27","27","18","27","8","","2021-02-11","0"
"38","38","38","26","38","11","","2021-02-25","0"
"33","33","33","23","33","10","","2021-03-11","0"
"35","35","35","24","35","10","","2021-03-25","0"
"31","31","31","21","31","9","","2021-04-08","0"
"33","33","33","23","33","10","","2021-04-22","0"
"33","33","33","23","33","10","","2021-05-06","0"
"31","31","31","21","31","9","","2021-05-20","0"
