"597","701","date","other"
"14","14","2017-04-13","0"
"22","21","2017-04-27","0"
"22","21","2017-05-11","0"
"23","22","2017-05-25","0"
"23","22","2017-06-08","0"
"21","20","2017-06-22","0"
"23","22","2017-07-06","0"
"21","20","2017-07-20","0"
"20","19","2017-08-03","0"
"21","20","2017-08-17","0"
"10","9","2017-08-31","0"
"15","14","2017-09-14","0"
"13","13","2017-09-28","0"
"16","16","2017-10-12","0"
"12","11","2017-10-26","0"
"13","13","2017-11-09","0"
"15","14","2017-11-23","0"
"13","13","2017-12-07","0"
"13","13","2017-12-21","0"
"12","11","2018-01-04","0"
"12","11","2018-01-18","0"
"16","16","2018-02-01","0"
"13","13","2018-02-15","0"
"15","14","2018-03-01","0"
"13","13","2018-03-15","0"
"13","13","2018-03-29","0"
"15","14","2018-04-12","0"
"23","22","2018-04-26","0"
"23","22","2018-05-10","0"
"23","22","2018-05-24","0"
"21","20","2018-06-07","0"
"23","22","2018-06-21","0"
"23","22","2018-07-05","0"
"23","22","2018-07-19","0"
"23","22","2018-08-02","0"
"23","22","2018-08-16","0"
"23","22","2018-08-30","0"
"23","22","2018-09-13","0"
"23","22","2018-09-27","0"
"23","22","2018-10-11","0"
"23","22","2018-10-25","0"
"23","22","2018-11-08","0"
"23","22","2018-11-22","0"
"23","22","2018-12-06","0"
"23","22","2018-12-20","0"
"23","22","2019-01-03","0"
"23","22","2019-01-17","0"
"23","22","2019-01-31","0"
"23","22","2019-02-14","0"
"23","22","2019-02-28","0"
"13","13","2019-03-14","0"
"3","3","2019-03-28","0"
"21","20","2019-04-11","0"
"23","22","2019-04-25","0"
"8","8","2019-05-09","0"
"15","15","2019-05-23","0"
"24","23","2019-06-06","0"
"24","23","2019-06-20","0"
"22","21","2019-07-04","0"
"24","23","2019-07-18","0"
"24","23","2019-08-01","0"
"21","20","2019-08-15","0"
"24","23","2019-08-29","0"
"22","21","2019-09-12","0"
"24","23","2019-09-26","0"
"22","21","2019-10-10","0"
"24","23","2019-10-24","0"
"19","18","2019-11-07","0"
"22","21","2019-11-21","0"
"24","23","2019-12-05","0"
"24","23","2019-12-19","0"
"22","21","2020-01-02","0"
"24","23","2020-01-16","0"
"26","25","2020-01-30","0"
"24","23","2020-02-13","0"
"24","23","2020-02-27","0"
"24","23","2020-03-12","0"
"24","23","2020-03-26","0"
"24","23","2020-04-09","0"
"26","25","2020-04-23","0"
"35","34","2020-05-07","0"
"32","31","2020-05-21","0"
"36","35","2020-06-04","0"
"32","31","2020-06-18","0"
"39","38","2020-07-02","0"
"34","33","2020-07-16","0"
"36","35","2020-07-30","0"
"39","38","2020-08-13","0"
"36","35","2020-08-27","0"
"32","31","2020-09-10","0"
"39","38","2020-09-24","0"
"34","33","2020-10-08","0"
"39","38","2020-10-22","0"
"39","38","2020-11-05","0"
"39","38","2020-11-19","0"
"44","42","2020-12-03","0"
"36","35","2020-12-17","0"
"36","35","2020-12-31","0"
"36","35","2021-01-14","0"
"44","42","2021-01-28","0"
"22","21","2021-02-11","0"
"39","38","2021-02-25","0"
"34","33","2021-03-11","0"
"34","33","2021-03-25","0"
"34","33","2021-04-08","0"
"34","33","2021-04-22","0"
"34","33","2021-05-06","0"
"34","33","2021-05-20","0"
