"19","21","122","1663","1680","1685","1687","1719","1774","3839","3859","4150","4182","4345","4667","date","other"
"10","5","5","9","4","8","4","1","7","5","8","9","2","7","8","2017-09-13","1"
"76","40","33","63","32","56","32","9","54","42","58","68","14","52","55","2017-09-27","11"
"77","40","33","64","33","58","33","9","55","43","60","69","14","52","56","2017-10-11","13"
"77","40","33","64","34","58","33","11","55","44","61","70","16","52","56","2017-10-25","18"
"78","42","34","65","35","60","34","11","57","45","62","71","16","53","57","2017-11-08","20"
"79","42","34","67","35","62","35","11","58","47","66","73","14","53","58","2017-11-22","22"
"79","42","34","67","35","63","35","11","58","48","66","73","14","53","58","2017-12-06","26"
"81","42","35","69","37","65","37","13","59","50","68","75","16","54","58","2017-12-20","25"
"84","45","38","73","40","68","41","16","63","53","72","78","19","58","62","2018-01-03","38"
"84","45","37","73","40","68","41","16","63","53","72","78","19","58","63","2018-01-17","38"
"84","45","37","73","40","68","41","16","63","53","72","78","19","58","63","2018-01-31","38"
"85","46","39","75","42","70","42","17","65","55","74","80","19","60","65","2018-02-14","41"
"85","46","39","75","43","70","42","17","65","55","75","81","19","60","65","2018-02-28","41"
"85","46","39","76","43","71","43","17","66","56","76","82","20","61","66","2018-03-14","41"
"85","46","39","76","43","72","43","17","66","57","76","82","20","61","66","2018-03-28","41"
"91","49","42","81","46","77","46","18","71","61","81","88","21","65","71","2018-04-11","44"
"85","46","39","76","43","72","43","17","66","57","76","82","20","61","66","2018-04-25","41"
"85","46","39","76","43","72","43","17","66","57","76","82","20","61","66","2018-05-09","41"
"85","46","39","76","43","72","43","17","67","58","76","82","20","61","66","2018-05-23","41"
"85","46","39","77","43","73","43","17","67","58","76","83","20","62","66","2018-06-06","40"
"85","46","39","77","43","73","43","17","67","58","76","83","20","62","66","2018-06-20","41"
"86","46","39","78","44","75","44","17","69","60","77","84","20","63","66","2018-07-04","41"
"86","46","39","78","44","75","44","17","69","60","77","84","20","63","66","2018-07-18","41"
"86","46","39","78","44","75","44","17","69","60","77","84","20","63","66","2018-08-01","41"
"86","45","38","79","43","75","44","16","69","60","77","84","19","64","66","2018-08-15","38"
"87","45","38","80","44","76","45","16","70","61","78","85","20","65","67","2018-08-29","37"
"87","45","38","80","44","76","45","16","70","61","78","85","20","65","67","2018-09-12","37"
"88","46","39","81","44","76","46","16","71","62","78","85","21","66","68","2018-09-26","37"
"88","46","39","81","44","76","46","16","71","62","78","85","21","66","68","2018-10-10","37"
"88","46","39","81","44","76","46","16","71","62","78","85","21","66","68","2018-10-24","37"
"88","46","39","81","44","76","46","16","71","62","78","86","22","66","68","2018-11-07","39"
"88","46","39","81","44","76","46","16","71","62","78","86","23","66","68","2018-11-21","39"
"88","46","39","81","44","76","46","16","71","62","78","86","24","66","68","2018-12-05","39"
"88","46","39","82","44","76","46","16","71","62","78","87","25","66","68","2018-12-19","39"
"88","46","39","82","44","76","46","16","71","62","78","87","26","66","68","2019-01-02","39"
"88","46","39","82","44","76","46","16","71","62","78","87","26","66","68","2019-01-16","39"
"88","46","39","82","44","76","46","16","71","62","78","87","26","66","68","2019-01-30","39"
"88","46","39","82","44","76","46","16","71","62","78","87","26","66","68","2019-02-13","39"
"89","46","39","83","44","77","46","16","72","63","79","88","27","66","68","2019-02-27","39"
"89","46","39","83","44","77","46","16","72","63","79","88","27","66","68","2019-03-13","39"
"89","46","39","84","44","77","46","16","72","63","79","88","28","66","68","2019-03-27","39"
"89","46","39","84","44","77","46","16","72","63","79","88","28","66","68","2019-04-10","39"
"89","46","39","84","44","77","46","16","72","63","79","88","28","66","68","2019-04-24","39"
"45","23","20","42","22","39","23","8","36","32","40","44","14","33","34","2019-05-08","20"
"53","26","22","49","26","46","27","9","42","37","46","51","17","38","39","2019-05-22","22"
"99","49","42","92","49","86","50","17","78","70","86","96","31","71","73","2019-06-05","42"
"92","46","39","86","46","80","47","16","73","65","80","90","29","66","68","2019-06-19","39"
"92","46","39","86","46","80","47","16","73","65","80","90","29","66","68","2019-07-03","39"
"92","46","39","86","46","80","47","16","73","65","80","90","29","66","68","2019-07-17","39"
"92","46","39","86","46","80","47","16","73","65","80","90","29","66","68","2019-07-31","39"
"85","43","36","80","43","74","44","15","68","60","74","84","27","61","63","2019-08-14","36"
"92","46","39","86","47","80","47","16","73","65","80","91","29","63","65","2019-08-28","39"
"85","43","36","80","44","74","44","15","68","60","74","85","27","43","45","2019-09-11","36"
"99","49","42","92","50","86","50","17","78","70","86","98","31","49","51","2019-09-25","42"
"92","46","39","86","47","80","47","16","73","65","80","91","29","46","48","2019-10-09","39"
"85","43","36","81","44","74","44","15","68","60","75","85","27","43","45","2019-10-23","36"
"85","43","36","81","44","74","44","15","68","60","75","85","27","43","45","2019-11-06","36"
"99","49","42","93","50","86","50","17","78","70","87","99","31","49","51","2019-11-20","42"
"112","56","47","106","57","97","57","19","89","80","98","112","35","56","58","2019-12-04","47"
"92","46","39","87","47","80","47","16","73","66","81","92","29","46","48","2019-12-18","39"
"92","46","39","87","47","80","47","16","73","66","81","92","29","46","48","2020-01-01","39"
"85","43","36","81","44","74","44","15","68","61","75","85","26","43","45","2020-01-15","36"
"92","46","39","87","47","80","47","16","73","66","81","92","28","46","48","2020-01-29","39"
"92","46","39","87","47","80","47","16","73","66","81","92","28","46","48","2020-02-12","39"
"105","53","45","99","54","91","54","18","83","75","93","105","32","53","55","2020-02-26","45"
"92","46","39","87","47","80","47","16","73","66","81","92","28","46","48","2020-03-11","39"
"105","53","45","99","54","91","54","18","83","75","93","105","32","53","55","2020-03-25","45"
"92","46","39","87","47","80","47","16","73","66","81","92","28","46","48","2020-04-08","39"
"99","49","42","93","50","86","50","17","78","71","87","99","30","49","51","2020-04-22","42"
"99","49","42","93","50","86","50","17","78","71","87","99","30","49","51","2020-05-06","42"
"85","43","36","81","44","74","44","15","68","61","75","85","26","43","45","2020-05-20","36"
"118","59","50","112","60","103","60","21","94","85","104","118","36","59","62","2020-06-03","50"
"92","46","39","87","47","80","47","16","73","66","81","92","28","46","48","2020-06-17","39"
"106","53","45","99","54","91","54","18","83","75","93","105","32","53","55","2020-07-01","45"
"86","43","36","81","44","74","44","15","68","61","75","85","26","43","45","2020-07-15","36"
"100","49","42","93","50","86","50","17","78","71","87","99","30","49","51","2020-07-29","42"
"80","39","33","75","40","69","40","14","63","57","69","79","24","39","41","2020-08-12","33"
"93","46","39","87","47","80","47","16","73","66","81","92","28","46","48","2020-08-26","39"
"93","46","39","87","47","80","47","16","73","66","81","92","27","46","48","2020-09-09","39"
"86","43","36","81","44","74","44","15","68","61","75","85","25","43","45","2020-09-23","36"
"106","53","45","99","54","91","54","18","83","75","93","105","31","53","55","2020-10-07","45"
"86","43","36","81","44","74","44","15","68","62","76","85","25","43","45","2020-10-21","36"
"133","66","56","124","67","114","67","23","104","96","117","131","39","66","69","2020-11-04","56"
"113","56","47","106","57","97","57","19","89","81","100","112","33","56","58","2020-11-18","47"
"106","53","45","99","54","91","54","18","83","77","94","105","31","53","55","2020-12-02","45"
"100","49","42","93","50","86","50","17","78","72","88","99","29","49","51","2020-12-16","42"
"126","62","53","118","64","109","64","22","99","91","111","125","37","62","65","2020-12-30","53"
"120","59","50","113","60","103","60","21","94","86","105","120","35","59","62","2021-01-13","50"
"100","49","42","94","50","86","50","17","78","72","88","100","29","49","51","2021-01-27","42"
"66","33","28","63","34","57","34","11","52","48","59","66","19","33","34","2021-02-10","28"
"126","62","53","119","64","109","64","22","99","91","111","126","37","62","65","2021-02-24","53"
"106","53","45","101","54","91","54","18","83","77","94","106","31","53","55","2021-03-10","45"
"106","53","45","101","54","91","54","18","83","77","94","106","31","53","55","2021-03-24","45"
"93","46","39","88","47","80","47","16","73","67","82","93","27","46","48","2021-04-07","39"
"120","59","50","113","60","103","60","21","94","86","105","120","35","59","62","2021-04-21","49"
"100","49","42","94","50","86","50","17","78","72","88","100","29","49","51","2021-05-05","41"
"113","56","47","107","57","98","57","19","89","82","100","113","33","56","58","2021-05-19","47"
