"21","492","493","1664","1755","3942","21978","date","other"
"2","2","","1","1","1","1","2018-03-14","0"
"11","11","","4","4","4","4","2018-03-28","0"
"23","22","","9","9","8","9","2018-04-11","0"
"30","29","","11","11","10","11","2018-04-25","0"
"32","31","","12","12","11","12","2018-05-09","0"
"32","31","","12","12","11","12","2018-05-23","0"
"32","31","","12","12","11","12","2018-06-06","0"
"32","31","","12","12","11","12","2018-06-20","0"
"32","31","","12","12","11","12","2018-07-04","0"
"32","31","9","12","12","11","12","2018-07-18","0"
"32","31","10","12","12","11","12","2018-08-01","0"
"32","31","10","12","12","11","12","2018-08-15","0"
"32","31","10","12","12","11","12","2018-08-29","0"
"32","31","10","12","12","11","12","2018-09-12","0"
"32","31","10","12","12","11","12","2018-09-26","0"
"32","31","10","12","12","11","12","2018-10-10","0"
"32","31","10","12","12","11","12","2018-10-24","0"
"32","31","10","12","12","11","12","2018-11-07","0"
"32","31","10","12","12","11","12","2018-11-21","0"
"32","31","10","12","12","11","12","2018-12-05","0"
"32","31","10","12","12","11","12","2018-12-19","0"
"32","31","10","12","12","11","12","2019-01-02","0"
"30","29","9","11","11","10","11","2019-01-16","0"
"32","31","10","12","12","11","12","2019-01-30","0"
"32","31","10","12","12","11","12","2019-02-13","0"
"32","31","10","12","12","11","12","2019-02-27","0"
"16","16","5","6","6","6","6","2019-03-13","0"
"5","4","1","2","2","2","2","2019-03-27","0"
"27","27","9","10","10","9","10","2019-04-10","0"
"32","31","10","12","12","11","12","2019-04-24","0"
"14","13","4","5","5","5","5","2019-05-08","0"
"18","18","6","7","7","6","7","2019-05-22","0"
"32","31","10","12","12","11","12","2019-06-05","0"
"34","33","11","13","13","12","13","2019-06-19","0"
"32","31","10","12","12","11","12","2019-07-03","0"
"32","31","10","12","12","11","12","2019-07-17","0"
"30","29","9","11","11","10","11","2019-07-31","0"
"30","29","9","11","11","10","11","2019-08-14","0"
"32","31","10","12","12","11","12","2019-08-28","0"
"30","29","9","11","11","10","11","2019-09-11","0"
"32","31","10","12","12","11","12","2019-09-25","0"
"32","31","10","12","12","11","12","2019-10-09","0"
"32","31","10","12","12","11","12","2019-10-23","0"
"30","29","9","11","11","10","11","2019-11-06","0"
"32","31","10","12","12","11","12","2019-11-20","0"
"32","31","10","12","12","11","13","2019-12-04","0"
"37","35","11","14","14","13","15","2019-12-18","0"
"34","33","11","13","13","12","14","2020-01-01","0"
"39","38","12","15","15","13","16","2020-01-15","0"
"37","35","11","14","14","13","15","2020-01-29","0"
"34","33","11","13","13","12","14","2020-02-12","0"
"30","29","9","11","11","10","12","2020-02-26","0"
"34","33","11","13","13","12","14","2020-03-11","0"
"41","40","13","15","15","14","17","2020-03-25","0"
"30","29","9","11","11","10","12","2020-04-08","0"
"30","29","9","11","11","10","12","2020-04-22","0"
"32","31","10","12","12","11","13","2020-05-06","0"
"30","29","9","11","11","10","12","2020-05-20","0"
"32","31","10","12","12","11","13","2020-06-03","0"
"32","31","10","12","12","11","13","2020-06-17","0"
"32","31","10","12","12","11","13","2020-07-01","0"
"30","29","9","11","11","10","12","2020-07-15","0"
"39","38","12","15","15","13","16","2020-07-29","0"
"27","27","9","10","10","9","11","2020-08-12","0"
"37","35","11","14","14","13","15","2020-08-26","0"
"27","27","9","10","10","9","11","2020-09-09","0"
"39","38","12","15","15","13","16","2020-09-23","0"
"34","33","11","13","13","12","14","2020-10-07","0"
"30","29","9","11","11","10","12","2020-10-21","0"
"43","42","14","16","16","15","18","2020-11-04","0"
"37","35","11","14","14","13","15","2020-11-18","0"
"39","38","11","15","15","13","16","2020-12-02","0"
"37","35","10","14","14","13","15","2020-12-16","0"
"39","38","11","15","15","13","16","2020-12-30","0"
"39","38","11","15","15","13","16","2021-01-13","0"
"39","38","11","15","15","13","16","2021-01-27","0"
"34","33","10","13","13","12","14","2021-02-10","0"
"37","35","10","14","14","13","15","2021-02-24","0"
"37","35","10","14","14","13","15","2021-03-10","0"
"32","31","9","12","12","11","13","2021-03-24","0"
"32","31","9","12","12","11","13","2021-04-07","0"
"34","33","10","13","13","12","14","2021-04-21","0"
"32","31","9","12","12","11","13","2021-05-05","0"
"32","31","9","12","12","11","13","2021-05-19","0"
