"492","701","21978","date","other"
"10","22","13","2018-03-15","0"
"20","43","25","2018-03-29","0"
"19","40","23","2018-04-12","0"
"21","44","25","2018-04-26","0"
"21","44","25","2018-05-10","0"
"21","44","25","2018-05-24","0"
"21","44","25","2018-06-07","0"
"21","44","25","2018-06-21","0"
"21","44","25","2018-07-05","0"
"21","44","25","2018-07-19","0"
"21","44","25","2018-08-02","0"
"21","44","25","2018-08-16","0"
"21","44","25","2018-08-30","0"
"21","44","25","2018-09-13","0"
"21","44","25","2018-09-27","0"
"21","44","25","2018-10-11","0"
"21","44","25","2018-10-25","0"
"21","44","25","2018-11-08","0"
"21","44","25","2018-11-22","0"
"21","44","25","2018-12-06","0"
"21","44","25","2018-12-20","0"
"21","44","25","2019-01-03","0"
"21","44","25","2019-01-17","0"
"21","44","25","2019-01-31","0"
"21","44","25","2019-02-14","0"
"21","44","25","2019-02-28","0"
"21","44","25","2019-03-14","0"
"20","41","23","2019-03-28","0"
"21","44","25","2019-04-11","0"
"21","44","25","2019-04-25","0"
"9","19","11","2019-05-09","0"
"14","28","16","2019-05-23","0"
"21","44","25","2019-06-06","0"
"24","50","29","2019-06-20","0"
"21","44","25","2019-07-04","0"
"24","50","29","2019-07-18","0"
"23","47","27","2019-08-01","0"
"20","41","23","2019-08-15","0"
"23","47","27","2019-08-29","0"
"20","41","23","2019-09-12","0"
"23","47","27","2019-09-26","0"
"23","47","27","2019-10-10","0"
"20","41","23","2019-10-24","0"
"20","41","23","2019-11-07","0"
"21","44","25","2019-11-21","0"
"24","50","29","2019-12-05","0"
"26","53","32","2019-12-19","0"
"23","47","28","2020-01-02","0"
"23","47","28","2020-01-16","0"
"21","44","26","2020-01-30","0"
"23","47","28","2020-02-13","0"
"20","41","24","2020-02-27","0"
"20","41","24","2020-03-12","0"
"23","47","28","2020-03-26","0"
"23","47","28","2020-04-09","0"
"21","44","26","2020-04-23","0"
"23","47","28","2020-05-07","0"
"21","44","26","2020-05-21","0"
"21","44","26","2020-06-04","0"
"21","44","26","2020-06-18","0"
"21","44","26","2020-07-02","0"
"21","44","26","2020-07-16","0"
"23","47","28","2020-07-30","0"
"21","44","26","2020-08-13","0"
"20","41","24","2020-08-27","0"
"20","41","24","2020-09-10","0"
"21","44","26","2020-09-24","0"
"21","44","26","2020-10-08","0"
"32","66","39","2020-10-22","0"
"27","57","33","2020-11-05","0"
"27","57","33","2020-11-19","0"
"23","47","28","2020-12-03","0"
"24","50","30","2020-12-17","0"
"27","57","33","2020-12-31","0"
"21","44","26","2021-01-14","0"
"32","66","39","2021-01-28","0"
"14","28","17","2021-02-11","0"
"29","60","35","2021-02-25","0"
"21","44","26","2021-03-11","0"
"23","47","28","2021-03-25","0"
"21","44","26","2021-04-08","0"
"23","47","28","2021-04-22","0"
"21","44","26","2021-05-06","0"
"21","44","26","2021-05-20","0"
