"19","21","492","3871","3964","4158","date","other"
"7","6","6","","","","2018-03-15","0"
"15","14","13","","","","2018-03-29","0"
"13","12","11","","","","2018-04-12","0"
"23","21","20","","","","2018-04-26","0"
"23","21","20","","","","2018-05-10","0"
"23","21","20","","","","2018-05-24","0"
"23","21","20","","","","2018-06-07","0"
"23","21","20","5","5","5","2018-06-21","0"
"23","21","20","5","5","5","2018-07-05","0"
"23","21","20","5","5","5","2018-07-19","0"
"23","21","20","5","5","5","2018-08-02","0"
"23","21","20","5","5","5","2018-08-16","0"
"23","21","20","5","5","5","2018-08-30","0"
"23","21","20","5","5","5","2018-09-13","0"
"23","21","20","5","5","5","2018-09-27","0"
"23","21","20","5","5","5","2018-10-11","0"
"23","21","20","5","5","5","2018-10-25","0"
"23","21","20","5","5","5","2018-11-08","0"
"23","21","20","5","5","5","2018-11-22","0"
"23","21","20","5","5","5","2018-12-06","0"
"23","21","20","6","6","5","2018-12-20","0"
"23","21","20","6","6","5","2019-01-03","0"
"23","21","20","6","6","5","2019-01-17","0"
"23","21","20","6","6","5","2019-01-31","0"
"23","21","20","6","6","5","2019-02-14","0"
"23","21","20","6","6","5","2019-02-28","0"
"15","14","13","4","4","3","2019-03-14","0"
"3","3","3","1","1","1","2019-03-28","0"
"23","21","20","6","5","5","2019-04-11","0"
"23","21","20","6","5","5","2019-04-25","0"
"10","9","9","3","2","2","2019-05-09","0"
"15","14","13","4","3","3","2019-05-23","0"
"23","21","20","6","5","5","2019-06-06","0"
"28","26","24","7","6","6","2019-06-20","0"
"26","24","23","7","6","6","2019-07-04","0"
"25","23","21","6","5","5","2019-07-18","0"
"23","21","20","6","5","5","2019-08-01","0"
"23","21","20","6","5","5","2019-08-15","0"
"26","24","23","7","6","6","2019-08-29","0"
"25","23","21","6","5","5","2019-09-12","0"
"25","23","21","6","5","5","2019-09-26","0"
"23","21","20","6","5","5","2019-10-10","0"
"23","21","20","6","5","5","2019-10-24","0"
"23","21","20","6","5","5","2019-11-07","0"
"23","21","20","6","5","5","2019-11-21","0"
"28","26","24","7","6","6","2019-12-05","0"
"25","23","21","6","5","5","2019-12-19","0"
"23","21","20","6","5","5","2020-01-02","0"
"26","24","23","7","6","6","2020-01-16","0"
"23","21","20","6","5","5","2020-01-30","0"
"26","24","24","8","7","6","2020-02-13","0"
"21","20","20","7","6","5","2020-02-27","0"
"20","18","18","6","5","4","2020-03-12","0"
"30","27","27","9","8","6","2020-03-26","0"
"31","29","29","10","8","7","2020-04-09","0"
"21","20","20","7","6","5","2020-04-23","0"
"23","21","21","7","6","5","2020-05-07","0"
"31","29","29","10","8","7","2020-05-21","0"
"25","23","23","8","6","5","2020-06-04","0"
"23","21","21","7","6","5","2020-06-18","0"
"29","27","26","9","7","6","2020-07-02","0"
"24","22","21","7","6","5","2020-07-16","0"
"27","25","24","8","7","6","2020-07-30","0"
"24","22","21","7","6","5","2020-08-13","0"
"22","20","20","7","6","5","2020-08-27","0"
"29","27","26","9","7","6","2020-09-10","0"
"22","20","20","7","6","5","2020-09-24","0"
"27","25","24","8","7","6","2020-10-08","0"
"21","19","18","6","5","4","2020-10-22","0"
"33","30","29","10","8","7","2020-11-05","0"
"31","28","27","9","8","6","2020-11-19","0"
"33","30","29","10","8","7","2020-12-03","0"
"22","20","20","7","6","5","2020-12-17","0"
"27","25","24","8","7","6","2020-12-31","0"
"26","24","23","8","6","5","2021-01-14","0"
"26","24","23","8","6","5","2021-01-28","0"
"17","16","15","5","4","4","2021-02-11","0"
"27","25","24","8","7","6","2021-02-25","0"
"24","22","21","7","6","5","2021-03-11","0"
"24","22","21","7","6","5","2021-03-25","0"
"24","22","21","7","6","5","2021-04-08","0"
"24","22","21","7","6","5","2021-04-22","0"
"26","24","23","8","6","5","2021-05-06","0"
"24","22","21","7","6","5","2021-05-20","0"
