"19","21","492","597","599","1664","4182","21978","999999","date","other"
"20","20","29","9","29","10","9","15","1","2017-01-05","0"
"21","21","31","10","31","11","10","16","1","2017-01-19","0"
"22","22","32","11","32","12","11","17","","2017-02-02","0"
"22","22","32","11","32","12","11","17","","2017-02-16","0"
"22","22","32","11","32","12","11","17","","2017-03-02","0"
"20","20","30","10","30","11","10","16","","2017-03-16","0"
"22","22","32","11","32","14","11","17","","2017-03-30","0"
"22","22","32","11","32","15","11","18","","2017-04-13","0"
"22","22","32","11","32","15","11","18","","2017-04-27","0"
"22","22","32","11","32","15","11","18","","2017-05-11","0"
"22","22","32","11","32","15","11","17","","2017-05-25","0"
"22","22","32","11","32","15","11","18","","2017-06-08","0"
"21","21","30","10","30","14","10","17","","2017-06-22","0"
"23","23","33","12","33","16","12","19","","2017-07-06","0"
"21","21","31","11","31","15","11","18","","2017-07-20","0"
"20","20","28","10","28","14","10","16","","2017-08-03","0"
"21","21","31","11","31","15","11","18","","2017-08-17","0"
"10","10","14","5","14","7","5","8","","2017-08-31","0"
"18","18","26","10","26","13","10","15","","2017-09-14","0"
"20","20","28","11","28","15","11","16","","2017-09-28","0"
"20","20","28","11","28","15","11","16","","2017-10-12","0"
"15","15","21","8","21","11","8","12","","2017-10-26","0"
"16","16","24","9","24","12","9","14","","2017-11-09","0"
"13","13","19","7","19","10","8","11","","2017-11-23","0"
"18","18","26","10","26","13","11","16","","2017-12-07","0"
"18","18","26","10","26","13","11","16","","2017-12-21","0"
"18","18","26","10","26","13","11","16","","2018-01-04","0"
"15","15","21","8","21","11","9","13","","2018-01-18","0"
"16","16","24","9","24","12","10","14","","2018-02-01","0"
"13","13","19","7","19","10","8","11","","2018-02-15","0"
"16","16","24","9","24","12","10","14","","2018-03-01","0"
"20","20","28","11","28","15","12","17","","2018-03-15","0"
"13","13","19","7","19","10","8","11","","2018-03-29","0"
"15","15","21","8","21","11","9","13","","2018-04-12","0"
"23","23","33","13","33","17","14","20","","2018-04-26","0"
"23","23","33","13","33","17","14","20","","2018-05-10","0"
"23","23","33","13","33","17","14","20","","2018-05-24","0"
"21","21","31","12","31","16","13","19","","2018-06-07","0"
"23","23","33","13","33","17","14","20","","2018-06-21","0"
"23","23","33","13","33","17","14","20","","2018-07-05","0"
"23","23","33","13","33","17","14","20","","2018-07-19","0"
"23","23","33","13","33","17","14","20","","2018-08-02","0"
"23","23","33","13","33","17","14","20","","2018-08-16","0"
"23","23","33","13","33","17","14","20","","2018-08-30","0"
"23","23","33","13","33","17","14","20","","2018-09-13","0"
"23","23","33","13","33","18","14","21","","2018-09-27","0"
"23","23","33","13","33","18","14","21","","2018-10-11","0"
"23","23","33","14","33","18","14","21","","2018-10-25","0"
"23","23","33","14","33","18","14","21","","2018-11-08","0"
"23","23","33","14","33","18","14","21","","2018-11-22","0"
"23","23","33","14","33","18","14","21","","2018-12-06","0"
"23","23","33","14","33","19","14","22","","2018-12-20","0"
"23","23","33","14","33","19","14","22","","2019-01-03","0"
"23","23","33","14","33","19","14","22","","2019-01-17","0"
"23","23","33","14","33","19","14","22","","2019-01-31","0"
"23","23","33","14","33","19","14","22","","2019-02-14","0"
"23","23","33","14","33","19","14","22","","2019-02-28","0"
"13","13","19","8","19","11","8","13","","2019-03-14","0"
"7","7","9","4","9","5","4","6","","2019-03-28","0"
"23","23","33","14","33","19","14","22","","2019-04-11","0"
"23","23","33","14","33","19","14","22","","2019-04-25","0"
"8","8","12","5","12","7","5","8","","2019-05-09","0"
"15","15","21","9","21","12","9","14","","2019-05-23","0"
"25","25","35","15","35","20","15","24","","2019-06-06","0"
"23","23","33","14","33","19","14","22","","2019-06-20","0"
"23","23","33","14","33","19","14","22","","2019-07-04","0"
"23","23","33","14","33","19","14","22","","2019-07-18","0"
"21","21","31","13","31","18","13","20","","2019-08-01","0"
"20","20","28","12","28","16","12","19","","2019-08-15","0"
"25","25","35","15","35","20","15","24","","2019-08-29","0"
"20","20","28","12","28","16","12","19","","2019-09-12","0"
"23","23","33","14","33","19","14","22","","2019-09-26","0"
"23","23","33","14","33","19","14","22","","2019-10-10","0"
"23","23","33","14","33","19","14","22","","2019-10-24","0"
"20","20","28","12","28","16","12","19","","2019-11-07","0"
"21","21","31","13","31","18","13","20","","2019-11-21","0"
"23","23","33","14","33","19","14","23","","2019-12-05","0"
"25","25","35","15","35","20","15","25","","2019-12-19","0"
"23","23","33","14","33","19","14","23","","2020-01-02","0"
"21","21","31","13","31","18","13","21","","2020-01-16","0"
"21","21","31","13","31","18","13","21","","2020-01-30","0"
"25","25","35","15","35","20","15","25","","2020-02-13","0"
"25","25","35","15","35","20","15","25","","2020-02-27","0"
"21","21","31","13","31","18","13","21","","2020-03-12","0"
"21","21","31","13","31","18","13","21","","2020-03-26","0"
"25","25","35","15","35","20","15","25","","2020-04-09","0"
"23","23","33","14","33","19","14","23","","2020-04-23","0"
"23","23","33","14","33","19","14","23","","2020-05-07","0"
"23","23","33","14","33","19","14","23","","2020-05-21","0"
"23","23","33","14","33","19","14","23","","2020-06-04","0"
"23","23","33","14","33","19","14","23","","2020-06-18","0"
"23","23","33","14","33","19","14","23","","2020-07-02","0"
"20","20","28","12","28","16","12","20","","2020-07-16","0"
"23","23","33","14","33","19","14","23","","2020-07-30","0"
"66","66","94","40","94","54","40","66","","2020-08-13","0"
"25","25","35","15","35","20","15","25","","2020-08-27","0"
"23","23","33","14","33","19","14","23","","2020-09-10","0"
"26","26","38","16","38","22","16","26","","2020-09-24","0"
"31","31","45","19","45","26","19","31","","2020-10-08","0"
"28","28","40","17","40","23","17","28","","2020-10-22","0"
"28","28","40","17","40","23","17","28","","2020-11-05","0"
"30","30","42","18","42","24","18","30","","2020-11-19","0"
"28","28","40","17","40","23","17","28","","2020-12-03","0"
"33","33","47","20","47","27","20","33","","2020-12-17","0"
"26","26","38","16","38","22","16","26","","2020-12-31","0"
"28","28","40","17","40","23","17","28","","2021-01-14","0"
"30","30","42","18","42","24","18","30","","2021-01-28","0"
"13","13","19","8","19","11","8","13","","2021-02-11","0"
"28","28","40","17","40","23","17","28","","2021-02-25","0"
"25","25","35","15","35","20","15","25","","2021-03-11","0"
"23","23","33","14","33","19","14","23","","2021-03-25","0"
"26","26","38","16","38","22","16","26","","2021-04-08","0"
"23","23","33","14","33","19","14","23","","2021-04-22","0"
"26","26","38","16","38","22","16","26","","2021-05-06","0"
"25","25","35","15","35","20","15","25","","2021-05-20","0"
