"21","122","1716","1720","date","other"
"11","11","6","6","2017-02-17","0"
"22","22","13","12","2017-03-03","0"
"22","22","14","13","2017-03-17","0"
"22","22","14","13","2017-03-31","0"
"22","22","14","13","2017-04-14","0"
"22","22","14","13","2017-04-28","0"
"22","22","14","13","2017-05-12","0"
"22","22","14","13","2017-05-26","0"
"22","22","14","13","2017-06-09","0"
"23","23","15","14","2017-06-23","0"
"23","23","15","14","2017-07-07","0"
"23","23","15","14","2017-07-21","0"
"20","20","13","12","2017-08-04","0"
"20","20","13","12","2017-08-18","0"
"13","13","9","8","2017-09-01","0"
"23","23","15","14","2017-09-15","0"
"21","21","14","13","2017-09-29","0"
"21","21","14","13","2017-10-13","0"
"21","21","14","13","2017-10-27","0"
"20","20","13","12","2017-11-10","0"
"23","23","15","14","2017-11-24","0"
"21","21","14","13","2017-12-08","0"
"21","21","14","13","2017-12-22","0"
"20","20","13","12","2018-01-05","0"
"20","20","13","12","2018-01-19","0"
"18","18","11","11","2018-02-02","0"
"18","18","11","11","2018-02-16","0"
"22","22","14","13","2018-03-02","0"
"19","19","12","11","2018-03-16","0"
"19","19","12","11","2018-03-30","0"
"21","21","13","12","2018-04-13","0"
"24","24","15","14","2018-04-27","0"
"24","24","15","14","2018-05-11","0"
"24","24","15","14","2018-05-25","0"
"22","22","14","13","2018-06-08","0"
"24","24","15","14","2018-06-22","0"
"24","25","15","15","2018-07-06","0"
"24","25","15","15","2018-07-20","0"
"24","25","15","15","2018-08-03","0"
"24","25","15","15","2018-08-17","0"
"24","25","15","15","2018-08-31","0"
"24","25","15","15","2018-09-14","0"
"22","23","14","14","2018-09-28","0"
"26","27","16","16","2018-10-12","0"
"24","25","15","15","2018-10-26","0"
"24","25","15","15","2018-11-09","0"
"24","25","15","15","2018-11-23","0"
"24","25","15","15","2018-12-07","0"
"24","25","15","15","2018-12-21","0"
"24","25","15","15","2019-01-04","0"
"22","23","14","14","2019-01-18","0"
"24","25","15","15","2019-02-01","0"
"24","25","15","15","2019-02-15","0"
"24","25","15","15","2019-03-01","0"
"14","14","9","9","2019-03-15","0"
"10","11","6","6","2019-03-29","0"
"24","25","15","15","2019-04-12","0"
"24","25","15","15","2019-04-26","0"
"7","7","4","4","2019-05-10","0"
"21","22","14","14","2019-05-24","0"
"27","28","17","17","2019-06-07","0"
"25","26","15","16","2019-06-21","0"
"30","32","18","19","2019-07-05","0"
"23","24","14","15","2019-07-19","0"
"25","26","15","16","2019-08-02","0"
"23","24","14","15","2019-08-16","0"
"25","26","15","16","2019-08-30","0"
"23","24","14","15","2019-09-13","0"
"27","28","16","17","2019-09-27","0"
"27","28","16","17","2019-10-11","0"
"27","28","16","17","2019-10-25","0"
"23","24","14","15","2019-11-08","0"
"27","28","16","17","2019-11-22","0"
"25","26","15","16","2019-12-06","0"
"36","37","21","23","2019-12-20","0"
"32","33","19","21","2020-01-03","0"
"25","26","15","16","2020-01-17","0"
"25","26","15","16","2020-01-31","0"
"25","26","15","16","2020-02-14","0"
"34","35","20","22","2020-02-28","0"
"23","24","14","15","2020-03-13","0"
"29","30","17","18","2020-03-27","0"
"27","28","16","17","2020-04-10","0"
"25","26","15","16","2020-04-24","0"
"30","32","18","19","2020-05-08","0"
"25","26","15","16","2020-05-22","0"
"27","28","16","17","2020-06-05","0"
"25","26","15","16","2020-06-19","0"
"27","28","16","17","2020-07-03","0"
"23","24","14","15","2020-07-17","0"
"50","52","30","32","2020-07-31","0"
"23","24","14","15","2020-08-14","0"
"27","28","16","17","2020-08-28","0"
"27","28","16","17","2020-09-11","0"
"27","28","16","17","2020-09-25","0"
"25","26","15","16","2020-10-09","0"
"27","28","16","17","2020-10-23","0"
"29","31","17","19","2020-11-06","0"
"32","35","19","22","2020-11-20","0"
"30","33","18","21","2020-12-04","0"
"32","35","19","22","2020-12-18","0"
"36","39","21","24","2021-01-01","0"
"34","37","20","23","2021-01-15","0"
"30","33","18","21","2021-01-29","0"
"21","23","13","15","2021-02-12","0"
"34","37","20","23","2021-02-26","0"
"25","27","15","17","2021-03-12","0"
"25","27","15","17","2021-03-26","0"
"25","27","15","17","2021-04-09","0"
"25","27","15","17","2021-04-23","0"
"25","27","15","17","2021-05-07","0"
"25","27","15","17","2021-05-21","0"
