"9","599","701","12472","date","other"
"5","5","5","","2017-10-12","0"
"15","15","16","1","2017-10-26","0"
"20","20","20","11","2017-11-09","0"
"18","18","19","10","2017-11-23","0"
"14","14","14","8","2017-12-07","0"
"14","14","14","8","2017-12-21","0"
"15","15","16","9","2018-01-04","0"
"12","12","13","7","2018-01-18","0"
"15","15","16","9","2018-02-01","0"
"14","14","14","8","2018-02-15","0"
"14","14","15","8","2018-03-01","0"
"11","11","12","7","2018-03-15","0"
"8","8","8","5","2018-03-29","0"
"19","18","20","11","2018-04-12","0"
"20","20","21","12","2018-04-26","0"
"22","21","23","13","2018-05-10","0"
"22","21","23","13","2018-05-24","0"
"22","22","24","14","2018-06-07","0"
"22","22","24","14","2018-06-21","0"
"22","22","24","14","2018-07-05","0"
"22","22","24","14","2018-07-19","0"
"22","22","24","14","2018-08-02","0"
"22","22","24","14","2018-08-16","0"
"22","22","24","14","2018-08-30","0"
"22","22","24","14","2018-09-13","0"
"22","22","24","14","2018-09-27","0"
"22","22","24","14","2018-10-11","0"
"22","22","24","14","2018-10-25","0"
"22","22","24","14","2018-11-08","0"
"22","22","24","14","2018-11-22","0"
"22","22","24","14","2018-12-06","0"
"22","22","24","14","2018-12-20","0"
"22","22","24","14","2019-01-03","0"
"22","22","24","14","2019-01-17","0"
"22","22","24","14","2019-01-31","0"
"22","22","24","14","2019-02-14","0"
"22","22","24","14","2019-02-28","0"
"11","11","12","7","2019-03-14","0"
"2","2","2","1","2019-03-28","0"
"20","20","22","13","2019-04-11","0"
"22","22","24","14","2019-04-25","0"
"8","8","9","5","2019-05-09","0"
"14","14","15","9","2019-05-23","0"
"24","24","26","15","2019-06-06","0"
"24","24","26","15","2019-06-20","0"
"22","22","24","14","2019-07-04","0"
"22","22","24","14","2019-07-18","0"
"22","22","24","14","2019-08-01","0"
"20","20","22","13","2019-08-15","0"
"22","22","24","14","2019-08-29","0"
"22","22","24","14","2019-09-12","0"
"20","20","22","13","2019-09-26","0"
"22","22","24","14","2019-10-10","0"
"22","22","24","14","2019-10-24","0"
"19","19","21","12","2019-11-07","0"
"24","24","26","15","2019-11-21","0"
"22","22","24","14","2019-12-05","0"
"24","24","26","15","2019-12-19","0"
"24","24","26","15","2020-01-02","0"
"25","25","27","16","2020-01-16","0"
"22","22","24","14","2020-01-30","0"
"22","22","24","14","2020-02-13","0"
"22","22","24","14","2020-02-27","0"
"20","20","22","13","2020-03-12","0"
"24","24","26","15","2020-03-26","0"
"24","24","26","15","2020-04-09","0"
"22","22","24","14","2020-04-23","0"
"24","24","26","15","2020-05-07","0"
"22","22","24","14","2020-05-21","0"
"22","22","24","14","2020-06-04","0"
"25","25","27","16","2020-06-18","0"
"24","24","26","15","2020-07-02","0"
"19","19","21","12","2020-07-16","0"
"24","24","26","15","2020-07-30","0"
"22","22","24","14","2020-08-13","0"
"25","25","27","16","2020-08-27","0"
"19","19","21","12","2020-09-10","0"
"27","27","29","17","2020-09-24","0"
"22","22","24","14","2020-10-08","0"
"20","20","22","13","2020-10-22","0"
"24","24","26","15","2020-11-05","0"
"24","24","26","15","2020-11-19","0"
"24","24","26","15","2020-12-03","0"
"22","22","24","14","2020-12-17","0"
"25","25","27","16","2020-12-31","0"
"35","35","38","22","2021-01-14","0"
"30","30","33","19","2021-01-28","0"
"20","20","22","13","2021-02-11","0"
"28","28","31","18","2021-02-25","0"
"27","27","29","17","2021-03-11","0"
"22","22","24","14","2021-03-25","0"
"22","22","24","14","2021-04-08","0"
"22","22","24","14","2021-04-22","0"
"22","22","24","14","2021-05-06","0"
"22","22","24","14","2021-05-20","0"
